QQRRRRQQWWWWWWWW
QR--O-QQWE-EPE-W
Q------QW-E-E-EW
Q------QWE-E-E-W
Q------QW-E-E-EW
Q----Q-QWE-E-E-W
QC---Q-QW-E-E-EW
QSQ--R-QWE-E-E-W
QQQZZQCQWWWXXWWW
QQQQQQQQWWWWWWWW