QQQQQQQQWWWWWWWW
Q----O-RRRRRRRRW
Q------RR-P----W
QC-----RR-----CW
QC-----RR-----CW
QC-----RR-----CW
QC-----RR-----CW
QC-----RR-----CW
QZZZZZZZXXXXXXXW
QQQQQQQQWWWWWWWW