QQQQQQQQWWWWWWWW
Q--O---QW--P---W
QQQQQ--QW--WWWWW
QQQQQ--QW--WWWWW
Q------QW------W
Q--QQQQQWWWWW--W
Q--QQQQQWWWWW--W
Q------QWSA----W
QQQZZQQQWWWXXWWW
QQQQQQQQWWWWWWWW