QQQQQQQQWWWWWWWW
QQQQ-O-QWW-RPWWW
QQQ-E--QWW--EWWW
QQQ--QQQW-ERWWWW
QR-----QW-WR-S-W
QR--CCQQW------W
Q---CCRQW---A--W
QZ--QQQQW------W
QQQQQQQQWWWXXWWW
QQQQQQQQWWWWWWWW