QQQQQQQQWWWWWWWW
QQQO-QQQWWW--WWW
QQQ--QQQWWWP-WWW
QQQ--QQQWWW--WWW
QQQ--QQQWWW--WWW
QQQ--QQQWWW--WWW
QQQ--QQQWWW--WWW
QQQ--QQQWWW--WWW
QQQZZQQQWWWXXWWW
QQQQQQQQWWWWWWWW