QQQQQQQQWWWWWWWW
QQQ-QQQQWWWP-R-W
QQROQQQQWW-----W
QRR-ERQQWW---R-W
QC-E---QWWRRRR-W
Q--Q---QWWWWRR-W
Q--C--EQW------W
QRRQ---QWA----WW
QQQQRZQQWSWWXWWW
QQQQQQQQWWWWWWWW