QQQQQQQQWWWWWWWW
QQQ-O-QQWSW-P-EW
QQQQ-ERQW-W--AEW
QC---RRQW-WR--RW
QC---RRQW-WR--RW
Q-----QQW-WR-ERW
Q-----QQW------W
QQ---QQQW------W
QZZQQQQQWWWXXWWW
QQQQQQQQWWWWWWWW