QQQQQQQQWWWWWWWW
QCQ---QQW----P-W
Q-Q--OQQW--A---W
Q----QQQWWW-W--W
Q--QQQQQWWWWW--W
Q-QQQQQQW------W
Q------CW-S----W
QRQ---QQW-----WW
QQQZZQQQWWWXXWWW
QQQQQQQQWWWWWWWW
