QQQQQQQQWWWWWWWW
Q-QQOQQQWWWWWPWW
QC---E-QWW--WEWW
Q-Q--QQQWW-----W
Q-Q--QQQWW-W-A-W
Q-QQQQQQW--WEEEW
QE----CQW----SEW
Q------QW---EEEW
QQQZZQQQWWWWXXWW
QQQQQQQQWWWWWWWW