QQQQQQQQWWWWWWWW
Q--O---QW--P---W
Q------QW------W
Q------QW------W
Q-----CQW--A---W
Q------QW----S-W
QQQ--QQQWWW--WWW
QQQ--QQQWWW--WWW
QQQZZQQQWWWXXWWW
QQQQQQQQWWWWWWWW